###################################################
#                                                 #
#                                                 #
#############                                     #
#...........#                                     #
###########.#                ######################
#.........#.#                #.......#............#
#########.#.#                #       #.           #
#       #.#.#                #        .           #
#       #.#.#                #.......#.           #
#       #.#.#                #.......#............#
#                            ################### .#
#                                                 #
#                                                 #
#                                                 #
#                                                 #
#                                                 #
###################################################